14
0 0 0 0 0 0 0 0 0 0 0 0 0 0 
0 0 0 0 0 0 0 0 10 0 0 0 0 0 
0 0 0 0 0 0 0 0 0 0 0 0 0 0 
0 0 0 0 0 0 0 0 0 0 0 0 0 0 
0 0 0 0 0 0 0 10 0 0 0 0 10 0 
0 0 0 0 0 0 0 10 0 10 0 0 0 0 
0 0 0 10 0 0 0 0 0 0 0 10 10 0 
0 0 -10 0 0 0 10 0 0 0 0 0 0 0 
0 0 10 0 0 10 0 0 0 0 0 0 0 0 
0 0 0 0 -10 0 0 10 0 0 0 0 10 0 
0 10 0 10 0 10 0 0 0 0 0 0 0 0 
0 0 10 0 0 0 0 0 10 0 10 0 0 10 
0 0 0 0 0 0 0 0 0 0 0 0 0 0 
10 0 0 0 0 0 0 0 0 0 10 0 0 0 